20 7
0 18
6 12
XXXXXXXXXXXXXXXXXX X
X     X      XXXXX X
X X X X X  X X  XX X
X X XXX XXXX XX XX X
X X        X XX XX X
X XXXXXXXXXX     X X
XXXXXXXXXXXX XXXXXXX

# No solution to this maze
# but visit all reachable locations
*** Solving maze3.txt
Failed to solve: maze3.txt
XXXXXXXXXXXXXXXXXX X
X+++++X++++++XXXXX X
X+X+X+X+X++X+X++XX X
X+X+XXX+XXXX+XX+XX X
X+X++++++++X+XX+XX X
X+XXXXXXXXXX+++++X X
XXXXXXXXXXXX+XXXXXXX